1111111110001001100010011000000111100001100000011000000111111111