11111111
10001001
10001001
10000001
10000001
10000001
11111111