SO ./texture/wall01.xpm
NO ./texture/wall02.xpm
EA ./texture/wall03.xpm
WE ./texture/wall04.xpm

F 255,102,204
C 0,250,154





        1111111111111111111111111
        1000000000110000000000001
        1011000001110000000000001
        10010000000000000N0000011
111111111011000001110000000000001
100000000011000001110111111111111
11110111111111011100000010001
11110111111111011101010010001
11000000110101011100000010001
10000000000000001100000010001
10000000000000001101010010001
11000001110101011101011010011
11110111 1110101 101111010001
11111111 1111111 111111111111