SO ./texture/texture6.xpm
NO ./texture/texture2.xpm
EA ./texture/texture3.xpm
WE ./texture/texture5.xpm

F 255,102,204
C 0,250,154





        111111111111111111111
        100000000011000000001
        1011000000000N0000001
        100100000000000000011
11111111101100000111000000001
10000000001100000111011111111
11110111111111011100000010001
10000000000000001100000010001
11000001110101011101011010011
11110111 1110101 101111010001
11111111 1111111 111111111111