SO ./texture/texture7.xpm
NO ./texture/texture2.xpm
EA ./texture/texture3.xpm
WE ./texture/texture5.xpm

F 255,102,204
C 0,250,154





11111111
10100001
1010N001
10100001
10000001
10000101
10000001
11111111